#########_
______#___
_####_###_
_####_###_
A_________
      __# 