#####____B
______#___
_####_###_
_####_###_
A_________