#_#_#_#_#_#_#_#_#_#_#_#_#_#_####___#_#___#_#_A
__#___#__#__#_____#__#__#__#_____#__#__#__#__#
#__#___#__#__#__#_____#__#_____#____________##
______#B###____#____#___#____#_______#___#____
##_##____________##_###_______#_____#####_###_
######################____####________________